00000000000000000000000000000000
11111111110000000000000000000000
00000000010011111110000000000000
01111110010010000010000000000000
01000010010010000011110000000000
01111011110010000000010000000000
00001000000110000000010000000000
00001111111100001111111111111000
00000000000000001000010000001000
00011111111111111000011111001000
00010000000000000000000001001000
00011111111111111111111111001000
00000000000000000000000000001111
00000000000000000000000000000000
00000000000000000000000000000000
00000000000000000000000000000000
00000000000000000000000000000000
